##########
#....#...#
###..#...#
#........#
#..#.....#
#..#.....#
#..#.#...#
#..#.#...#
#..#.#...#
##########
