..########
#....#...#
###..#...#
#........#
#..#.....#
#..#.....#
#..#.#...#
#..#.#...#
#..#.#...#
########..
